######
#    ##
#  =  #
# O=O #
## = ##
 # = #
 # X #
 ##P##
  ###