      ####
####### X#
# O O OO #
#   p XXX#
###   ####
  #####