    #####
#####   ##
#   #O#  #
#   OXp# #
## ##XX  #
#  #X  ###
#  O O #
#  #####
####