  #####
 ##   ###
 #      #
 #=#=#= #
 # #pO ##
## # #X#
#      #
#   #  #
########