#### ####
#  ###  #
# O = O #
#   P   #
### XO###
  # X #
  #####