     ####
 #####  #
 # O    #
## #X##O#
#  # pX #
#  XO # ##
## ##X#  #
 #    O  #
 #  ######
 ####