 ####
 #  #####
 #   O  #
 #O# #  #
##  P  ##
#  #X#O#
#  OX  #
### X ##
  #####