#####
#   ###
#X#O  #
# pO= #
#  O  #
##X#X##
 #   #
 #####