#### ####
#  ###  #
#  O O  #
# O#X## #
##  X   ##
 # XpX#O #
 ## #    #
  #   ####
  #####