 #####
##   ###
# XXX= #
# #pO# #
# O    #
### #O##
  #   #
  #####