 #########
 #  ##   #
##  =  # #
# XO#=p  #
#   =   ##
#########