  #####
  #   ###
###=# O #
# O p # #
# # XX  #
# X #O###
##OX  #
 #  ###
 ####