     ####
  ####  #
  #XX   #
### Op# ##
#  O #XX #
# O   O  #
####  ####
   ####