    ####
#####  #
# O   O#
#  X#X #
## ### ##
 # X#X  #
 #O p O #
 #  #####
 ####