  ########
  #   #  #
  #   OX #
 ###O##  #
 # OX## ##
##  X=   #
#  #O#   #
# Xp #####
##   #
 #####