  #######
 ##  #  #
 # = =  #
##   #  #
#  =#P ##
#     O#
#####  #
    ####