     ####
    ##  #
   ## X #
#### O  #
# O OXp##
#  X  ##
#######