  #####
  #   #
###=# ##
#    = #
# #  # #
# = P  #
##  #O##
 ##   #
  #####