     ####
 #####  #
 # O O  #
 #X# #X #
 # OpO ##
##X# #X##
#  = =  #
#   #   #
#########