   ####
####  #
#  O  ##
# #O#  #
#  O   #
#X###  #
#X#### #
#X p   #
########