 #####
 #   #
 # # ##
## =  ##
# O=O  #
#  = # #
## X  P#
 #######