 #####
##   #
#  #X##
# OOX #
## p  #
 # #X #
 # O ##
 # ###
 #  #
 #  #
 #  #
 ####