######
#   X#
# X p#
# # ###
# # O ##
# =X   ##
#### OO ##
   ##    #
    ##   #
     #####