  ####
###Xp###
#      #
# =XX# #
## #OO #
 #    ##
 ##O# #
  #   #
  #####