 ####
 #  #
##Xp#
# XO#####
# OO O  #
# XX    #
####  ###
   ####