  ####
###  ###
#   X  #
#  O O #
##X#P#X#
 # O O #
 ###  ##
   ####