 #######
 #  #  #
 #O P O#
 # X#X #
##OX#XO##
# O X O #
#   #   #
#########