  #####
###   ##
# OOXX #
# X p# #
## #   #
 # =O ##
 ###  #
   ####