  ####
###  #
#    ##
#  #  ###
## X X X#
##O##X#O##
# O  p O #
#   ##   #
##########