     ####
######  #
# O  O  #
# #  X# ##
#  X #Xp #
##O# =   #
 #   #####
 #####