  #####
  #P  ###
 ##=# O #
 # =    #
## = # ##
#  =   #
#   ####
#####