   ####
 ###  #
## pO #
# XO  #
# X= ##
# XO #
##  ##
 ####