 #####
 #   #
 # #O##
## p  #
# X#O #
# X  ##
# X#O#
##   #
 #####