  #####
###   #
#  =# ##
# #  = #
# =  # #
## #P  #
 #   O##
 ###  #
   ####