 #####
 #   ###
## #O p#
# X O  #
#XXX#O##
# #  O #
#  #   #
##   ###
 #####