     #####
 #####   #
 # O X # #
 # # OO  #
## ## # ##
#  OXOX #
# ##   ##
#  XpX##
#######