########
#   =  #
# P=== #
##  O  #
 ##   ##
  ##  #
   ####