#################
#  #  #  #  #   #
#XO   #  #XO    #
#  #XO XO   #   #
# p#  #  #  #   #
#################