########
#      #
#  X   #
#  O X #
# XOpO #
#   O  #
#   X  #
########