######## 
#      # 
#  X   # 
#  O OX# 
# XOp  # 
#   O  # 
#   X  # 
######## 