  ##### 
###   #
#   # ##
# #  P #
#  O # #
## #   #
 #   ###
 #####