  ##### 
###   #
#   # ##
# #  X #
#  O # #
## #   #
 #p  ###
 #####