#######
#  p  #
#  b  #
#     #
#  g  #
#     #
#######