  ##### 
###   #
# O # ##
# #  X #
#    # #
## #   #
 #p  ###
 #####