  ##### 
###   #
# O # ##
# #  X #
# X  # #
##O#XO #
 #p  ###
 #####