  ####
 ##  #
## X ##
#pOOO #
#X X# #
# #   #
#   ###
#####