  #####
###   ##
#  O#  #
#  XpXO##
##X# #  #
 # O    #
 ##  ####
  ####