#########
###   ###
#  O#  ##
#  XpXO##
##X# #  #
## O    #
###  ####
#########