  ##### 
###   #
#   # ##
# #O X #
#  p # #
## #   #
 #   ###
 #####