   ####
####  ##
#   O  #
#  === #
#  X X ##
## = =  #
 ##===  #
  # O ###
  # p #
  #####