##########
#  #   X #
#    #   #
#    # p #
# #####O #
#  #  #  #
#  #     #
#      # #
##########