#######################
#       X#            #
#      #   #          #
#      #####          #
#      O #            #
#        #     pO     #
# ##########          #
#      #   #          #
#      #              #
#           #X        #
#######################