   #####
 ###   #
##     #
# === ##
#  =p #
# X=O##
##   #
 ##  #
  ####