 #######
 #  #  ##
## ==OX #
#   #   #
#   p ###
#  ####
####