########
#   #  #
#      #
## #X X#
#    ###
# # = #
# OO# #
###  p#
  #####