    ####
#####  #
#   O  #
# =X#  #
## ## ##
#      #
# p#   #
#  #####
####