 #####
 #   ##
## #O ##
# O    #
#X X#  #
### p ##
  # # #
  #   #
  #####