#####
#   ###
# X   #
## O  #
####O##
#  O ##
# p   #
###X X#
  #####