####
#  ###
#    ##
# X#O #
## p  #
 #X#O##
 #   #
 #####