    ####
 ####  #
## O   #
#  # #O#
#XpX   ##
## # #  #
 #      #
 #  #####
 ####