   ####
####  #
# O O #
#  X# ##
## #X  #
# p  O #
#X  ####
#####