  #####
###   #
#     #
#  #X###
##pOOO #
 #X#X# #
 #     #
 #  ####
 ####