 #####
 #   ##
##X#O ##
# O    #
#X X#O #
### p ##
  # # #
  #   #
  #####