 #######
##  #  #
#  ==OX##
#   #   #
### p   #
  ####  #
     ####