 #####
##   ###
# X X  #
# # ## ##
#    OOp#
### #   #
  #   ###
  #####