    ####
 ####  #
## O   #
#  # #O#
#XpXX  ##
## # #  #
 #   O  #
 #  #####
 ####