#####
#   ###
#     #
##    #
####O##
#  O ##
# p   #
###X X#
  #####