  ####
  #  ###
 ## X  #
##pOOO #
# X X ##
#   ###
#  ##
####