    ####
#####  #
#   O  #
#  X#  #
## ## ##
#      #
# p#   #
#  #####
####