 ####
 #  ####
 #     #
 # #X  #
##=##O##
#      #
# # p  #
#    ###
######