 ####
 #  ####
 #     #
 # #X  #
##=##O##
#    = #
# # p  #
#    ###
######