  #####
###   #
# O # ##
# #  X #
#    # #
##O#X  #
 #p  ###
 #####