   ####
####  #
# O   #
#  X# ##
## #X  #
# p  O #
#   ####
#####