########
#      #
# XO   #
#    p #
########