      ####
#######  #
#        #
#  O #X# #
# OO## # ##
### X p   #
  ###  #  #
    ##X  ##
     #####