 #####
 #   #
##O# ###
#   Op #
# #  # #
# #X X #
#   ####
#####