    ####
#####  #
#   =  #
# =X#  #
## ## ##
# O    #
# p#   #
#  #####
####