     ####
   ###  #
 ### XX #
 # OO#  #
## # #p##
#  =    #
#   #   #
######  #
     ####