 #####
##   ###
# X X X#
# # ## ##
#    OOp#
### # O #
  #   ###
  #####