      ####
#######  #
#        #
#  O #X# #
#  O## # ##
###   p   #
  ###  #  #
    ##X  ##
     #####