 #####
 #   #
##O# ###
#  XOp #
# #  # #
# #XXO #
#   ####
#####