    #####
   ##   ##
  ## X#  #
 ##   p  #
##  = #  #
#  O #####
# = ##
#  ##
####