####
#  ####
#     #
#     #
### ###
# OOO ##
# XXXp #
####   #
   #####