  ####
 ##  #
##   ##
#  =O #
# # #p#
#  =X #
###  ##
  #  #
  ####