####
#  ####
#     #
#     #
### ###
# OO  ##
# X Xp #
####   #
   #####