  ####
###  ###
#   =O #
# #  #p#
# # =X #
#   ####
#####