#####
#   ##
# #  ###
#   =O #
###  #p#
  # =X #
  #  ###
  ####