     ####
   ###  #
 ### XX #
 # OO#  #
## # #p##
#       #
#   #   #
######  #
     ####