########
#   #  #
#      #
## #X  #
#    ###
# # X #
# OO# #
###  p#
  #####